###############################
#                             #
#    #                   #    #
#                             #
#                             #
#                             #
#                             #
#                             #
#                #            #
#   #                         #
#                             #
#                             #
#                             #
#             SSSS            #
#                             #
#       #                     #
#                             #
#                      #      #
#                             #
#                             #
#     #                       #
#                             #
#                             #
#                             #
#                    #        #
#                             #
#    #                        #
#                             #
#                #            #
#                             #
###############################
