###############################
#                             #
#                             #
#    ########     ########    #
#    #      #     #      #    #
#    #      #     #      #    #
#    #      #     #      #    #
#    #      #     #      #    #
#    #      #     #      #    #
#    #      #     #      #    #
#    #      #     #      #    #
#    ########     ########    #
#                             #
#                             #
#                             #
#              SSSS           #
#                             #
#                             #
#                             #
#    ########     ########    #
#    #      #     #      #    #
#    #      #     #      #    #
#    #      #     #      #    #
#    #      #     #      #    #
#    #      #     #      #    #
#    #      #     #      #    #
#    #      #     #      #    #
#    ########     ########    #
#                             #
#                             #
###############################
